Total Budget,14000.0

Transactions
date,category,amount,total_budget,remaining_balance
2025-04-22,food,4500.0,14000.0,9500.0
2025-04-22,food,120.0,14000.0,9380.0
2025-04-22,travel,3500.0,14000.0,5880.0
2025-04-22,bills,450.0,14000.0,5430.0
2025-04-22,food,150.0,14000.0,5280.0
2025-04-22,entertainment,1000.0,14000.0,4280.0
2025-04-22,bills,780.0,14000.0,3500.0

Category Totals
category,total_spent
bills,1230.0
entertainment,1000.0
food,4770.0
travel,3500.0

Remaining Balance,3500.0
